TTTTTTTTTTTTTTTTTTT
T                 T
T   R  TTTTT      T
   X              T
T    R     T      T
T       TTTTT     T
T                  .
T                 T
T                 T
T                 T
TTTTTTTTTTTTTTTTTTT
