T     T T       T T
T X T T T TTX X T T
T R T   T   T X   T
TXT TTT TTX T RTT T
T T T   R   T R   T
T T TTTTR TTX TTT T
  T         X   R  
T T TTTTXTT TTT T T
T R T   T     R T T
T RTT T TTTTTTT T T
T     T         T T
