5
TTTTTTTTTTTTTTTTTTT
T                 T
T   R  TTTTT      T
                  T
T    R     T      T
T       TTTTT     T
T                   T
T                 T
T                 T
T                 T
TTTTTTTTTTTTTTTTTTT
