T           T     T
T TTTTTTT T TTTTT T
T X       T     R T
T R XTTRXXXTTTR R T
T T T   T     T   T
T T T T T TTRTXTT T
  T   T T          
T TTT X T TRTTTTT T
T   R T T T   T   T
TTT TXT T T T XTT T
T       T   T     T
