TTTTTTTTTTTTTTTTTTTTTTTTTTTTTT
TRTRTRRTXXRX RR TTXT T TTRTTXT
TX RX TTTXR R   T XXTXXTXRR TT
T RXR TRRXRRTX    TXX RTTXXRTT
TR R R RX  TXXX T    XTTTX XTT
T TRR XRRXT X   XRRTRTXTXRT TT
T  XTRX R X XT  X XXRRR XXXRXT
TXTXXTRR T XRT  TTXTTXT T  RRT
TR RRT XT RXTTR  RXXTXTTTRRT T
TXXX  TXTTT TR  T XTXRX T XTRT
XXTXTRXXXXRRRXX  RTX   XRRTR T
TTX TXXTRRXXXT  XR XRRRRRRXT T
TRX TRXXRT RXX  XRRT TXXRXRTRT
T RXXR TRRT  TT XTXRTRTXRTTRTT
T RRTRXXRT XRX  RTRTTXTR TTTXT
TT   R XX XR  X  RR RTRTTXXTTT
TTXTXRRR T RTTX XXTXT RXTXTTRT
TX T RRTR X X   TRTXT XX RX XT
T  RRXXXRTXRXR  XTTR  X R RRRT
TTTTTTTTTTTTTTTTTTTTTTTTTTTTTT
