1
TTTTTTTTTTTTTTTTTTTTTTTTTTTTTT
 TXR XRTR  RT TTXRTTRXXRX  XXT
TTTRTTTTXT TR  XRX X RRR RTRTT
T XXTTX RR XRXXRTTXTRXRR   XTT
TXTTTT  TR RTTTRTTXXTTTT TTXXT
TX    XTX RRR  XT TXRX TRTXT T
T T T T  TRTRTRR XTRRRTXR X RT
TXRXX R XRTXXTX TT T X RR RX T
T XX  XTXRT R XRT  R  TTRRR TT
TTRR    RXRT  RRXTTRT X XR X T
T X X  TTRTXRTR  X   TR   TX T
T  TXT X X TTR  TRRT  TXRXXTTT
TT TXR XRT RTTTXR   RRRX XTTRT
TXRRXTT X X  X TXTTT  RXXRX XT
TRTXXX XTRT RTX X RRTTR R  RXT
TTRXXTX  XRTXTRXX XTTR TX TTXT
TTR TRTT RRRTRRXT XR XRXXRXXTT
TRXXRXRXX RTXR  XRX TX X TRTTT
TX TXXTTXT TRRXXTXXX XXT  XXRT
TTTTTTTTTTTTTTTTTTTTTTTTTTTTTT
